NFFGFGFFGGRAAAAAAAAAASFFGGFFGFFO
MAAAAAAAAAAAAAAAAAAAAAAAAAAAAAAJ
LAAAAAAAAAAAAAAAAAAAAAAAAAAAAAAJ
LAAAAAAAAAAAAAAAAAAAAAAAAAAAAAAK
MAAAAAAAAAAAAAAAAAAAAAAAAAAAAAAJ
MAAAAAAAAAAEBBBCCCBCDAAAAAAAAAAJ
LAAAAAAAAAAAAAAAAAAAAAAAAAAAAAAK
LAAAAAAAAAAAAAAAAAAAAAAAAAAAAAAJ
LAAAAAAAAAAAAAAAAAAAAAAAAAAAAAAJ
HBBCCBCDAAAAAAAAAAAAAAAAEBBCBCBI
LAAAAAAAA`AAAAAAAAAAAAAAAAAAAAAK
MAAAAAAAA`AAAAAAAAAAAAAAAAAAAAAJ
LAAAAAAAAabAAAAAAAAAAAAAAAAAAAAK
LAAAAAECCBCBDAAAAAAEBCBCCDAAAAAJ
MAAAAAAAAAAAAAAAAAAAAAAAAAAAAAAJ
LAAAAAAAAAAAAAAAAAAAAAAAAAAAAAAJ
LAAAAAAAAAAAAAAAAAAAAAAAAAAAAAAJ
MAAAAECBCBCBBCCBCCBCBBCBBCDAAAAK