NFFGFGFFGGRAAAAAAAAAASFFGGFFGFFO
MAAAAAAAAAAAAAAAAAAAAAAAAAAAAAAJ
LAAAAAAAAAAAAAAAAAAAAAAAAAAAAAAJ
LAAAAAAAAAAAAAAAAAAAAAAAAAAAAAAK
MAAAAAAAAAAAAAAAAAAAAAAAAAAAAAAJ
MAAAAAAAAAAEBBBCCCBCDAAAAAAAAAAJ
LAAAAAAAAAAAAAAAAAAAAAAAAAAAAAAK
LAAAAAAAAAAAAAAAAAAAAAAAAAAAAAAJ
LAAAAAAAAAAAAAAAAAAAAAAAAAAAAAAJ
HBBCCBCDAdeAAAAAAAAAAAAAEBBCBCBI
LAAAAAAAA`aAAAAAAAAAAAAAAAAAAAAK
MAAAAAAAA`aAAAAAAAAAAAAAAAAAAAAJ
LAAAAAAAAbcAAAAAAAAAAAAAAAAAAAAK
LAAAAAECCBCBDAAAAAAEBCBCCDAAAAAJ
MAAAAAAAAAAAAAAAAAAAAAAAAAAAAAAJ
LAAAAAAAAAAAAAAAAAAAAAAAAAAAAAAJ
LAAAAAAAAAAAAAAAAAAAAAAAAAAAAAAJ
MAAAAECBCBCBBCCBCCBCBBCBBCDAAAAK