FAAAAAAAAAAAAAAAAAAAAAAAAAAAAAAG
FAAAAAAAAAAAAAAAAAAAAAAAAAAAAAAG
FAAAAAAAAAAAAAAAAAAAAAAAAAAAAAAG
FAAAAAAAAAAAAJHHHHHKAAAAAAAAAAAG
FAAAAAAAAAAAAGDEBDEFAAAAAAAAAAAG
FAAAAAAAAAAAAGBBBBBFAAAAAAAAAAAG
FAAAAAAAAAAAAebc`bcdAAAAAAAAAAAG
LHHHHHKAAAAAAe`````dAAAAAAJHHHHM
BDEBDEFXAAAAAebc`bcdAAAAAVGCBDEB
BBBBBBFAAAAAAe`````dAAAAAAGBBBBB
BDEBDEFAAAAAAebc`bcdAAAAAAGCBDEB
BBBBBBFAAAAAAJHHHHHKAAAAAAe````G
BDEBDEFAAAAAAGDEBDEFAAAAAAea`bcG
BBBBBBFAAAAAAGBBBBBFAAAAAAe````G
BDEBDEFAAAAAAGDEBDEFAAAAAAea`bcG
BBBBBBFAAAAAAGBBBBBFAAAAAAJHHHHB
BDEBDEFAAAAAAGDEBDEFAAAAAAGCBDEB
BBBBBBFAAAAAAGBBBBBFAAAAAAGBBBBB