FAAAAAAAAAAAAAAAAAAAAAAAAAAAAAAG
FAAAAAAAAAAAAAAAAAAAAAAAAAAAAAAG
FAAAAAAAAAAAAAAAAAAAAAAAAAAAAAAG
FAAAAAAAAAAAAJHHHHHKAAAAAAAAAAAG
FAAAAAAAAAAAAGDEBDEFAAAAAAAAAAAG
FAAAAAAAAAAAAGBBBBBFAAAAAAAAAAAG
FAAAAAAAAAAAAebc`bcdAAAAAAAAAAAG
LHHHHHKAAAAAAe`````dAAAAAAAAAAAG
BDEBDEFAAAAAAebc`bcdAAAAAAAAAAAG
BBBBBBFAAAAAAe`````dAAAAAAAJHHHM
BDEBDEFAAAAAAebc`bcdAAAAAAAGCBCB
BBBBBBFAAAAAAe`````dAAAAAAAGBBBB
BDEBDEFAAAAAAebc`bcdAAAAAAAGCBCB
BBBBBBFAAAAAAJHHHHHKAAAAAAAGBBBB
BDEBDEFAAAAAAGDEBDEFAAAAAAAGCBCB
BBBBBBFAAAAAAGBBBBBFAAAAAAAGBBBB
BDEBDEFAAAAAAGDEBDEFAAAAAAAGCBCB
BBBBBBFAAAAAAGBBBBBFAAAAAAAGBBBB