FAAAAAAAAAAAAAAAAAAAAAAAAAAAAAAG
FAAAAAAAAAAAAAAAAAAAAAAAAAAAAAAG
FAAAAAAAAAAAAAAAAAAAAAAAAAAAAAAG
FAAAAAAAAAAJHHHHHHHHKAAAAAAAAAAG
FAAAAAAAAAAGBDEBBDEBFAAAAAAAAAAG
FAAAAAAAAAAGBBBBBBBBFAAAAAAAAAAG
FAAAAAAAAAAe`bc``bc`dAAAAAAAAAAG
LHHHHKAAAAAe````````dAAAAAJHHHHM
BDEBCFAAAAAe`bc``bc`dAAAAAGCBDEB
BBBBBFXAAAAe````````dAAAAVGBBBBB
Fbc`adAAAAAe`bc``bc`dAAAAAea`bcG
F````dAAAAAJHHHHHHHHKAAAAAe````G
Fbc`adAAAAAGBDEBBDEBFAAAAAea`bcG
F````dAAAAAGBBBBBBBBFAAAAAe````G
Fbc`adAAAAAGBDEBBDEBFAAAAAea`bcG
LHHHHKAAAAAGBBBBBBBBFAAAAAJHHHHM
BDEBCFAAAAAGBDEBBDEBFAAAAAGCBDEB
BBBBBFAAAAAGBBBBBBBBFAAAAAGBBBBB