NFFGFGFFGGRAAAAAAAAAASFFGGFFGFFO
KJJJJJJJJAAAAAAAAAAAAAAJJJJJJJJK
MJJAJJJJAAAAAAAAAAAAAAAAAAJJJJJJ
MJJAAAJJAAAAAAAAAAAAAAAAAAAAJJJJ
MJAAAAJAAAAAAAAAAAAAAAAAAAAAAJJK
LJAAAAJAAAAAAAAAAAAAAAAAAAAAAJJK
LJAAAAAAAAAAAAAAAAAAAAAAAAAAAAJJ
MAAAAAAAAAAAAAAAAAAAAAAAAAAAAAAK
LAAAAAAAAAAAAAAAAAAAAAAAAAAAAAAJ
MAAAAAAAAAAAAAAAAAAJAAAAAAAAAAAJ
LAAAAAAJJJAAAAAAAAJJJJAAAAAAAAAK
LAAAAAJJJJJJAAAAAJJJJJJJJAAAAAAK
MAAAAJJAAJJJJAAAAAJJJJJJAAAAAAAJ
MAAAAAAAAAAAAAAAAAAJJJAAAAAAAAAJ
LJAAAAAAAAAAAAAAAAAAAAAAAAAAAAAK
MJAAAAAAAAAAAAAAAAAAAAAAAAAAAAJK
MJJAAAAAAAAAAAAAAAAAAAAAAAAAJWJJ
PCBWCDAAAAAECCBCBCWCDAAAAAEBCCBQ